TTCACAAGCTA
TTCAACGAGGT
TTCACATTGGC
TTCACCACTGT
TTCAACGTGAT
TTCCGCTGATC
TTCCAGTGGAT
TTCATGCCTAA
TTCAAGCTCTC
TTCAGCACATC
TTCCATCAAGT
TTCAGTGGTCA
TTCAACAACCA
TTCAACCGAGA
TTCAACGCTTA
TTCAAGACGGA
TTCAAGGTACA
TTCACACAGAA
TTCACAGCAGA
TTCACCTCCAA
TTCACGCTCGA
TTCACGTATCA
TTCACTATGCA
TTCAGAGTCAA
TTCAGATCGCA
TTCAGCAGGAA
TTCAGTCACTA
TTCATCCTGTA
TTCATTGAGGA
TTCCAACCACA
TTCCAAGACTA
TTCCAATGGAA
TTCCACTTCGA
TTCCAGCGTTA
TTCCATACCAA
TTCCCAGTTCA
TTCCCGAAGTA
TTCCCGTGAGA
TTCCCTCCTGA
TTCCGAACTTA
TTCCGACTGGA
TTCCGCATACA
TTCCTCAATGA
TTCCTGAGCCA
TTCCTGGCATA
TTCGAATCTGA
TTCGACTAGTA
TTCGAGCTGAA
TTCGATAGACA
TTCGCCACATA
TTCGCGAGTAA
TTCGCTAACGA
TTCGCTCGGTA
TTCGGAGAACA
TTCGGTGCGAA
TTCGTACGCAA
TTCGTCGTAGA
TTCGTCTGTCA
TTCGTGTTCTA
TTCTAGGATGA
TTCTATCAGCA
TTCTCCGTCTA
TTCTCTTCACA
TTCTGAAGAGA
TTCTGGAACAA
TTCTGGCTTCA
TTCTGGTGGTA
TTCTTCACGCA
TTCACACGAGA
TTCAAGAGATC
TTCAAGGACAC
TTCAATCCGTC
TTCAATGTTGC
TTCACACTGAC
TTCACAGATTC
TTCAGATGTAC
TTCAGCACCTC
TTCAGCCATGC
TTCAGGCTAAC
TTCATAGCGAC
TTCACGACTAC
TTCATTGGCTC
TTCCAAGGAGC
TTCCACCTTAC
TTCCCATCCTC
TTCCCGACAAC
TTCAGTCAAGC
TTCCCTCTATC
TTCCGACACAC
TTCCGGATTGC
TTCCTAAGGTC
TTCGAACAGGC
TTCGACAGTGC
TTCGAGTTAGC
TTCGATGAATC
TTCGCCAAGAC
